3,3,3,3,4,3,4,3,3,3,3
3,3,3,3,4,3,4,3,3,3,3
3,3,3,3,4,3,4,3,3,3,3
3,3,7,3,3,3,3,3,7,3,3
3,7,6,7,3,3,3,7,6,7,3
7,7,7,7,7,3,7,7,7,7,7
3,3,3,3,3,3,3,3,3,3,3
3,6,6,6,6,6,6,6,6,6,3
3,6,6,6,6,6,6,6,6,6,3
3,3,3,3,3,3,3,3,3,3,3
6,6,6,6,3,4,3,6,6,6,6
