3,7,7,7,7,3,7,7,7,7,3
3,7,7,7,7,3,7,7,7,7,3
3,7,7,7,7,3,7,7,7,7,3
3,7,7,7,7,3,7,7,7,7,3
3,7,7,7,7,3,7,7,7,7,3
3,7,7,7,7,3,7,7,7,7,3
3,3,3,3,3,3,3,3,3,3,3
7,7,7,7,7,3,7,7,7,7,7
7,7,7,7,7,3,7,7,7,7,7
7,7,7,7,7,3,7,7,7,7,7
7,7,7,7,6,3,6,7,7,7,7
