0,211,212,209,0,501,0,609,0,201,202
0,105,106,105,0,102,0,0,0,0,0
0,0,0,0,0,103,0,0,0,0,0
0,0,103,0,0,102,0,0,0,0,209
0,0,405,0,0,0,0,0,105,0,0
0,0,108,114,0,502,0,0,0,103,401
0,0,401,0,0,0,0,0,402,0,401
0,0,0,0,0,0,0,0,106,0,0
0,206,203,207,0,0,0,0,114,114,114
0,0,208,0,0,0,0,0,0,0,0
0,0,0,0,0,301,0,0,0,209,201
