0,0,0,0,0,0,0,0,0,0,0
0,502,0,0,0,0,103,102,0,0,0
0,0,0,401,0,0,102,108,0,0,0
0,210,0,114,0,0,609,213,0,0,0
0,0,0,0,0,0,0,0,0,0,0
502,0,108,214,0,501,102,103,0,108,0
0,0,0,0,0,0,0,0,0,0,0
0,0,202,0,0,0,0,0,0,201,0
0,502,0,0,0,0,0,0,402,114,0
0,0,101,102,101,0,0,0,0,202,0
0,0,0,0,0,0,0,0,0,0,0
