0,0,0,0,501,0,0,0,0,0,501
0,0,0,0,124,0,0,0,201,202,203
0,0,0,0,103,0,0,0,0,0,0
0,0,0,0,109,0,0,212,115,211,0
0,0,0,0,120,0,0,0,0,0,209
0,0,0,115,117,0,0,207,117,209,0
0,0,0,401,0,0,0,0,0,0,0
118,118,0,208,201,0,0,206,0,502,118
118,0,0,0,106,0,0,0,0,0,124
121,121,0,106,106,0,0,0,405,212,211
0,0,0,0,0,0,0,0,0,0,0
