502,0,0,0,301,0,0,0,0,0,0
0,0,0,0,0,0,0,0,0,0,0
0,0,0,0,0,0,0,0,502,0,0
0,0,0,0,0,0,0,0,0,0,0
0,0,0,0,0,0,0,0,0,0,0
0,0,0,0,0,0,0,0,0,0,0
0,0,0,0,0,0,0,0,0,0,0
0,402,0,0,0,0,0,0,0,402,0
110,116,110,0,0,0,0,0,107,124,107
206,110,206,0,125,0,125,0,207,107,207
210,220,210,0,501,0,501,0,209,203,209
