501,0,0,0,0,502,0,0,201,109,0
0,0,405,0,0,0,0,0,0,501,0
0,0,0,0,0,0,0,0,109,0,116
202,116,124,0,206,501,207,0,104,0,110
0,0,110,0,124,110,124,0,0,0,0
0,0,0,0,0,0,0,0,0,0,0
0,0,0,0,0,401,0,0,0,0,104
107,0,0,0,0,0,0,0,0,0,117
0,0,0,0,0,0,0,0,209,0,0
0,0,0,0,0,0,0,0,0,0,0
0,104,0,0,117,124,0,0,0,502,0
