0,0,108,0,0,502,0,0,108,0,0
0,0,0,0,0,0,0,0,0,0,0
0,0,209,207,0,110,405,108,201,0,0
0,0,0,110,0,0,0,0,211,0,0
108,0,0,405,0,403,0,0,0,0,108
109,0,0,0,0,113,0,0,0,0,109
108,0,0,0,0,401,0,0,0,0,108
0,0,0,110,405,109,0,203,212,0,0
0,0,210,206,0,0,0,110,0,0,0
0,0,0,0,0,0,0,405,0,0,0
0,0,110,0,0,501,0,0,110,0,0
