0,301,0,0,201,209,0,0,401,0,0
109,0,0,0,0,0,0,120,0,116,117
0,0,0,0,0,0,0,120,0,201,213
109,0,116,0,0,124,401,0,0,0,0
0,0,0,0,0,0,0,117,402,117,0
0,0,402,0,104,0,0,0,0,209,0
0,502,118,401,0,0,0,401,0,104,0
0,0,402,0,104,0,401,121,0,0,0
207,117,0,0,0,0,0,0,0,0,0
0,124,0,0,0,0,124,115,0,0,0
0,206,0,0,0,501,0,116,0,0,0
