206,0,0,0,0,501,0,0,0,0,207
104,0,0,0,0,0,0,0,0,0,104
0,0,0,0,0,104,0,0,0,0,0
0,0,0,0,0,0,0,0,0,0,0
403,0,0,0,0,403,0,0,0,0,403
103,0,0,0,0,103,0,0,0,0,103
0,0,102,102,0,0,0,102,102,0,0
0,0,0,0,0,401,0,0,0,0,0
0,0,0,0,0,101,0,0,0,0,0
0,0,0,0,0,0,0,0,0,0,0
0,0,0,0,0,504,0,0,0,0,0
