0,0,0,0,0,0,0,0,0,0,0
0,301,101,0,0,502,0,501,0,0,0
0,0,102,0,0,0,0,0,105,0,0
0,0,0,0,0,0,0,101,102,101,0
0,105,0,0,0,0,0,0,0,0,0
0,0,0,0,0,0,0,0,0,0,0
0,0,402,0,0,0,401,0,0,114,0
0,101,0,101,0,0,0,0,0,401,0
0,209,117,209,0,0,0,302,0,0,0
0,206,201,207,0,101,0,0,201,201,0
0,0,0,0,0,0,0,0,0,0,0
