0,0,502,0,201,201,0,0,0,0,0
0,121,403,0,201,115,0,0,0,0,0
201,0,0,0,0,401,0,121,0,106,0
0,114,118,0,0,202,0,401,0,118,0
0,109,0,201,0,0,0,0,0,0,0
501,0,0,0,0,0,0,109,0,0,0
0,114,108,0,401,105,0,209,0,0,0
0,209,0,209,0,105,0,210,0,114,0
0,0,0,0,0,0,0,0,0,0,0
0,604,605,606,0,0,0,0,0,401,0
0,207,0,206,402,114,0,502,0,0,0
