210,0,202,0,0,501,0,0,609,203,206
207,0,201,0,701,702,703,0,0,0,0
0,0,201,0,704,705,706,0,124,116,124
117,0,0,0,707,708,709,0,0,401,0
0,402,0,0,0,0,0,0,104,107,0
0,0,0,0,0,403,0,0,0,104,0
116,0,0,0,0,110,0,0,0,0,0
0,0,104,0,0,0,401,0,0,0,0
117,0,107,104,0,0,0,0,0,0,0
0,0,201,0,0,0,0,0,0,0,0
209,0,0,0,0,502,0,0,206,501,0
