0,0,115,0,502,0,109,120,109,0,502
0,0,106,0,0,0,0,0,0,0,0
0,0,0,0,120,0,0,0,0,0,0
213,0,403,0,118,0,0,115,117,0,109
206,0,125,0,0,0,0,117,0,0,0
207,0,0,0,403,0,0,401,0,0,0
216,0,0,0,0,0,0,401,0,0,124
209,0,116,0,0,0,0,401,0,0,402
210,0,110,0,0,0,0,205,0,0,402
119,0,110,0,106,501,124,121,124,0,0
0,0,0,0,0,0,0,0,0,0,0
