501,0,0,203,0,502,0,502,0,110,104
0,206,125,0,0,0,0,0,0,0,110
0,0,0,0,0,0,0,207,501,0,0
0,0,0,125,0,104,0,206,0,0,0
0,124,0,0,0,116,0,0,402,0,0
104,118,104,402,0,104,0,0,0,0,0
0,0,0,107,0,0,0,0,0,0,0
0,110,0,0,0,0,0,110,0,0,401
0,0,0,0,0,0,401,124,110,0,0
219,0,117,0,0,0,0,0,0,0,107
107,107,0,116,0,402,124,116,124,0,0
