502,0,403,503,0,501,0,501,0,0,0
0,0,0,0,0,104,0,0,0,502,0
0,0,0,0,124,0,0,110,0,0,0
211,212,0,0,0,502,0,116,0,0,0
0,0,0,0,0,0,0,110,0,201,203
0,107,405,124,0,0,0,0,0,116,107
209,209,0,125,124,202,0,0,0,125,124
0,0,0,0,401,0,0,0,0,209,210
0,113,0,0,205,209,0,0,0,0,0
0,0,0,0,0,0,0,0,0,0,0
0,0,0,119,119,218,0,104,124,104,0
