0,0,0,0,0,0,0,0,0,0,0
0,501,0,105,0,0,0,108,402,207,0
0,0,0,0,0,102,0,0,0,211,0
0,105,0,0,102,105,0,0,0,212,0
0,0,0,0,0,0,0,0,0,0,0
501,0,0,105,0,0,402,0,0,0,0
0,0,0,0,0,0,0,0,0,401,0
0,601,602,603,0,0,0,0,0,114,0
0,501,101,102,0,0,102,0,0,0,0
0,0,210,0,0,0,0,502,0,502,0
0,0,0,0,0,0,0,0,0,0,0
