0,121,0,0,0,120,106,0,0,117,201
0,118,0,0,401,0,0,0,0,0,0
0,103,0,0,0,0,0,0,0,0,117
0,0,0,206,0,0,0,207,0,0,115
0,0,0,206,0,116,0,207,0,0,0
502,0,0,201,402,123,402,201,0,0,501
0,0,0,210,0,116,0,209,0,0,0
0,0,0,210,0,0,0,209,0,301,210
106,106,0,0,0,401,0,0,0,206,207
0,0,0,120,0,0,0,108,0,109,109
0,0,0,120,0,0,0,108,0,0,0
