0,117,115,0,0,0,104,0,0,209,210
0,0,0,0,0,0,0,402,0,106,106
0,0,210,117,0,0,0,0,0,0,0
106,0,202,117,0,124,402,0,0,0,0
207,0,117,0,0,0,0,0,401,124,117
0,0,0,0,0,0,0,0,0,302,209
0,501,117,0,0,0,0,0,0,0,0
0,0,0,401,0,0,0,120,0,0,0
211,0,0,115,0,0,0,0,0,0,0
212,0,104,0,0,104,0,502,0,124,0
202,120,124,0,0,0,117,0,124,0,0
