206,0,0,0,0,501,0,0,0,0,207
209,107,0,0,0,106,107,107,0,107,209
201,0,0,107,107,405,0,0,0,0,201
0,0,0,0,0,405,0,0,0,0,0
0,0,0,0,0,0,0,0,0,0,0
0,0,0,0,0,0,0,0,0,0,0
106,0,106,0,0,0,0,106,105,0,0
405,0,405,0,0,405,0,0,405,0,405
107,0,107,0,0,105,0,0,107,107,107
0,0,0,0,0,0,0,0,0,107,0
201,202,201,0,0,502,0,0,0,203,0
