0,0,0,0,0,0,0,103,0,121,209
0,0,0,0,115,0,0,109,103,0,0
210,201,0,0,0,120,0,0,0,0,0
201,124,0,117,0,120,0,106,0,0,0
124,117,402,106,0,120,0,106,0,0,0
0,0,0,106,0,0,0,0,0,0,502
0,501,0,0,0,206,0,207,0,0,0
209,209,0,0,0,201,0,201,0,501,0
106,106,0,401,0,124,0,124,0,0,0
0,0,109,108,109,0,118,0,0,0,0
0,0,0,0,0,0,0,0,401,117,0
