215,0,501,0,0,502,0,108,0,0,0
0,117,0,0,0,0,0,0,0,0,0
203,115,0,0,0,0,0,0,0,114,0
0,0,0,401,0,202,0,0,0,0,0
0,106,0,0,0,201,0,103,0,0,105
0,0,0,0,0,0,0,0,0,401,0
0,118,401,0,0,210,0,0,0,0,0
0,0,0,0,0,206,0,0,0,0,0
0,0,0,0,0,0,105,0,0,0,108
0,109,0,0,0,0,0,0,0,0,0
0,206,0,0,103,0,0,501,0,0,209
