202,201,112,0,0,502,0,0,201,112,0
0,0,0,111,0,111,0,0,0,0,111
0,0,0,0,0,405,0,0,0,0,0
0,0,0,405,0,111,0,0,405,0,0
0,0,0,0,0,206,0,0,0,0,0
0,405,0,0,0,0,0,0,0,405,0
209,0,0,201,0,0,0,201,0,0,210
0,0,405,0,0,207,0,0,405,0,0
0,0,0,0,0,405,0,0,0,0,0
0,0,0,0,0,112,0,0,0,0,0
0,0,405,0,0,501,0,0,405,0,0
