0,0,0,0,0,0,0,0,0,0,0
0,206,207,0,0,607,0,502,0,0,0
0,209,209,0,0,0,0,0,0,0,0
0,0,116,0,107,405,0,0,102,0,0
0,0,403,0,0,0,0,0,0,0,0
0,0,124,0,403,0,202,0,0,0,0
0,401,0,401,0,0,0,101,0,105,0
0,0,0,206,0,0,0,101,0,105,0
0,203,0,207,0,201,0,0,0,210,0
0,203,0,0,202,302,0,501,0,501,0
0,0,0,0,0,0,0,0,0,0,0
