0,0,117,124,117,0,0,0,0,104,0
0,0,0,0,0,0,0,0,0,117,124
0,0,206,209,104,205,0,201,201,0,402
207,0,0,0,0,104,0,120,120,0,117
0,0,0,0,0,405,0,0,0,0,0
0,0,0,0,121,121,0,0,0,0,115
117,0,401,0,0,0,0,0,0,0,403
0,0,0,118,107,204,0,217,404,107,107
0,0,0,0,0,0,0,0,0,107,107
0,0,109,106,0,502,0,501,0,202,203
0,0,109,0,0,0,0,0,0,0,0
